蘄	蕲
誇	夸
氈	毡
漊	溇
預	预
龕	龛
辮	辫
瀠	潆
璣	玑
錢	钱
檇	槜
媧	娲
礦	矿
鶩	鹜
鰨	鳎
貳	贰
踴	踊
銷	销
鄶	郐
閹	阉
鐸	铎
輊	轾
談	谈
豈	岂
鏍	镙
駑	驽
癢	痒
織	织
腖	胨
軟	软
遠	远
嶺	岭
癤	疖
緩	缓
屨	屦
齪	龊
飩	饨
歲	岁
鐿	镱
鯽	鲫
黿	鼋
䴉	鹮
沈	沈,沉
個	个
劌	刿
鋙	铻
閎	闳
餑	饽
鰓	鳃
鮒	鲋
鼕	冬
憖	慭
攙	搀
頲	颋
謝	谢
檜	桧
丟	丢
無	无
鎢	钨
眥	眦
禦	御
氳	氲
殲	歼
鈷	钴
囈	呓
頻	频
媼	媪
綾	绫
摃	扛
闊	阔
曄	晔
賈	贾
運	运
鍍	镀
鋌	铤
嗎	吗
饑	饥
屓	屃
鯒	鲬
齕	龁
衛	卫
殞	殒
諜	谍
蹟	迹
鑣	镳
鏢	镖
盤	盘
姦	奸
虯	虬
嵒	岩
併	并
剷	铲
斃	毙
蠆	虿
贈	赠
劍	剑
鞏	巩
齙	龅
經	经
弔	吊
蘚	藓
鉛	铅
簷	檐
馱	驮
閣	阁
線	线
嚥	咽
頦	颏
鴨	鸭
憫	悯
梱	阃
唸	念
瘺	瘘
媽	妈
簾	帘
瘍	疡
釋	释
湊	凑
呎	尺
奐	奂
鷓	鹧
齔	龀
聖	圣
蕘	荛
櫝	椟
譜	谱
濟	济
鯧	鲳
鳩	鸠
絨	绒
繪	绘
蟯	蛲
該	该
鴇	鸨
遶	绕
詫	诧
燁	烨
螄	蛳
躊	踌
鈍	钝
鎌	镰
頑	顽
紓	纾
鸕	鸬
龔	龚
薘	荙
訝	讶
讜	谠
輟	辍
貞	贞
犢	犊
鬧	闹
鰩	鳐
鸝	鹂
脫	脱
麪	面
蠱	蛊
課	课
皺	皱
蟄	蛰
車	车
鉍	铋
鏌	镆
睏	困
慳	悭
鵓	鹁
髒	脏
繕	缮
軸	轴
別	别
壯	壮
轟	轰
賞	赏
啣	衔
勢	势
噥	哝
筧	笕
籩	笾
編	编
慫	怂
蓮	莲
迴	回
獷	犷
鑹	镩
彿	佛
糾	纠
戀	恋
煖	暖
鮑	鲍
纓	缨
餒	馁
錯	错
輞	辋
鎡	镃
閥	阀
復	复
耬	耧
朮	术
溳	涢
褲	裤
傷	伤
錶	表
嘸	呒
鮋	鲉
么	么,幺
凍	冻
瓏	珑
饒	饶
鱔	鳝
櫛	栉
鏡	镜
牠	它
監	监
煢	茕
闥	闼
瑤	瑶
磧	碛
鵪	鹌
擯	摈
詰	诘
襲	袭
淵	渊
鍶	锶
噸	吨
嫻	娴
蔔	卜
憂	忧
載	载
溈	沩
紕	纰
莖	茎
暘	旸
訛	讹
錡	锜
銠	铑
誰	谁
覲	觐
貴	贵
隸	隶
餽	馈
碼	码
擄	掳
毆	殴
轉	转
鉋	刨
駒	驹
絕	绝
詛	诅
襝	裣
補	补
陣	阵
顧	顾
實	实
黨	党
艫	舻
葯	药
鵒	鹆
賴	赖
遷	迁
痺	痹
飼	饲
鯔	鲻
攄	摅
躉	趸
颭	飐
閏	闰
礬	矾
頒	颁
純	纯
舖	铺
條	条
錠	锭
麩	麸
鴉	鸦
瀲	潋
譟	噪
鐺	铛
瀋	沈
綿	绵
績	绩
詆	诋
佈	布
兌	兑
塒	埘
輸	输
裝	装
湞	浈
鍠	锽
婦	妇
廩	廪
諱	讳
議	议
釷	钍
輕	轻
飽	饱
奼	姹
幾	几
會	会
複	复
誆	诓
祐	佑
階	阶
鮐	鲐
嶔	嵚
講	讲
撚	捻
亞	亚
厠	厕
傢	家
閤	合
羨	羡
許	许
輳	辏
滲	渗
儷	俪
鴿	鸽
甚	什,甚
揀	拣
襇	裥
鍋	锅
賊	贼
問	问
巔	巅
歛	敛
據	据
衝	冲
鑥	镥
奧	奥
繩	绳
鹽	盐
捫	扪
覦	觎
矓	胧
話	话
棲	栖
噹	当
謊	谎
銃	铳
綑	捆
弒	弑
攖	撄
檟	槚
閡	阂
礱	砻
鴦	鸯
撫	抚
嬪	嫔
漲	涨
訴	诉
餾	馏
摀	捂
韍	韨
鋏	铗
籐	藤
壓	压
齒	齿
鯕	鲯
櫟	栎
闡	阐
鑠	铄
鉤	钩
給	给
硨	砗
詢	询
慮	虑
當	当
釹	钕
選	选
獺	獭
翽	翙
繼	继
嫿	婳
吋	寸
變	变
圍	围
崑	昆
頓	顿
緯	纬
蘗	檗
輝	辉
訟	讼
鋱	铽
連	连
獰	狞
風	风
鮪	鲔
憮	怃
貰	贳
農	农
閶	阊
鰻	鳗
缽	钵
麼	麽,么
蕁	荨
蓀	荪
瑋	玮
囌	苏
鵑	鹃
顓	颛
習	习
體	体
顒	颙
揚	扬
機	机
灣	湾
鍥	锲
鋤	锄
鷦	鹪
奩	奁
鯪	鲮
曬	晒
嗶	哔
膃	腽
澇	涝
開	开
訊	讯
紐	纽
搖	摇
溝	沟
輜	辎
璡	琎
醣	糖
銥	铱
碩	硕
館	馆
吶	呐
鶻	鹘
爺	爷
麽	么
擁	拥
懃	勤
時	时
闋	阕
瑣	琐
過	过
結	结
叢	丛
髕	髌
慘	惨
仝	同
衞	卫
員	员
釣	钓
儺	傩
鋥	锃
鍤	锸
壩	坝
嶽	岳
驪	骊
華	华
槳	桨
譴	谴
執	执
價	价
緻	致
鉺	铒
黽	黾
鯿	鳊
薀	蕰
掄	抡
輇	辁
嘍	喽
簑	蓑
餓	饿
贛	赣
袞	衮
鈥	钬
窪	洼
蘭	兰
築	筑
褳	裢
鴻	鸿
總	总
墾	垦
佇	伫
韌	韧
驕	骄
篔	筼
臘	腊
歟	欤
痠	酸
離	离
鏤	镂
蟬	蝉
軲	轱
詵	诜
繽	缤
孿	孪
飾	饰
計	计
邏	逻
徑	径
縐	绉
鴒	鸰
禕	祎
掙	挣
梟	枭
銣	铷
產	产
粧	妆
暫	暂
礪	砺
萬	万
籜	箨
澱	淀
踰	逾
檳	槟
鈸	钹
鄺	邝
綽	绰
資	资
轆	辘
橈	桡
雋	隽
楊	杨
闍	阇
鑌	镔
烏	乌
獎	奖
峴	岘
駕	驾
軛	轭
慚	惭
棟	栋
埡	垭
鋣	铘
畢	毕
灤	滦
糧	粮
齦	龈
篩	筛
奪	夺
鶓	鹋
濱	滨
審	审
諳	谙
鏹	镪
鉸	铰
飿	饳
驁	骜
斂	敛
脅	胁
來	来
瘋	疯
瀏	浏
搗	捣
減	减
憚	惮
蠟	蜡
讞	谳
俱	具,俱
鈣	钙
兇	凶
鬩	阋
禪	禅
蔭	荫
櫳	栊
絲	丝
旂	旗
迆	迤
證	证
巒	峦
祕	秘
著	著,着
臚	胪
滻	浐
闢	辟
煥	焕
鱧	鳢
姪	侄
蕭	萧
擬	拟
聯	联
揮	挥
詳	详
極	极
鑷	镊
卹	恤
鋸	锯
釺	钎
掃	扫
肅	肃
涇	泾
銍	铚
檉	柽
甌	瓯
鈎	钩
鮓	鲊
鰒	鳆
濘	泞
貝	贝
樞	枢
鎣	蓥
嶧	峄
窩	窝
鬨	哄
澆	浇
攬	揽
燜	焖
効	效
錸	铼
盞	盏
紼	绋
禿	秃
騾	骡
慄	栗
諉	诿
韋	韦
衊	蔑
剎	刹
飢	饥
濛	蒙
詞	词
盡	尽
僥	侥
魨	鲀
勦	剿
訓	训
潰	溃
襴	襕
狹	狭
獸	兽
䰾	鲃
峽	峡
駿	骏
梔	栀
贇	赟
國	国
琍	璃
閌	闶
縑	缣
龐	庞
幃	帏
輛	辆
鸛	鹳
語	语
瘡	疮
膚	肤
崧	嵩
護	护
斬	斩
謳	讴
貲	赀
嚶	嘤
鈹	铍
為	为
簽	签
鶼	鹣
餿	馊
裊	袅
闌	阑
鹹	咸
駔	驵
敗	败
曖	暧
艙	舱
潛	潜
獻	献
諞	谝
癡	痴
釤	钐
師	师
穩	稳
鯨	鲸
飪	饪
濰	潍
觴	觞
長	长
祿	禄
潔	洁
綁	绑
紝	纴
謂	谓
鮍	鲏
纏	缠
冑	胄
錒	锕
嘔	呕
敘	叙
趙	赵
漚	沤
蔞	蒌
禡	祃
鬢	鬓
羥	羟
犧	牺
閩	闽
鐨	镄
殭	僵
撳	揿
鶲	鹟
餶	馉
鶹	鹠
鳲	鸤
賃	赁
藉	藉,借
壋	垱
穌	稣
絎	绗
諗	谂
襖	袄
礎	础
魢	鱾
寧	宁
鳶	鸢
嗩	唢
睪	睾
詬	诟
滯	滞
聰	聪
捲	卷
柵	栅
緹	缇
鱸	鲈
鏽	锈
輅	辂
戇	戆
撈	捞
錙	锱
鬍	胡
鸏	鹲
邐	逦
鐓	镦
託	托
視	视
䲘	鳤
餡	馅
簣	篑
麤	粗
鈧	钪
説	说
騷	骚
紹	绍
銼	锉
閾	阈
轅	辕
滄	沧
塋	茔
筍	笋
鶯	莺
號	号
壠	垅
鯢	鲵
彥	彦
釦	扣
譭	毁
櫬	榇
湯	汤
摳	抠
緒	绪
絹	绢
糸	丝
鋼	钢
訂	订
蘊	蕴
嬌	娇
導	导
傑	杰
儐	傧
間	间
嚕	噜
骯	肮
夠	够
綣	绻
麥	麦
鎧	铠
瀦	潴
鵝	鹅
謬	谬
辯	辩
賜	赐
戲	戏
滅	灭
轄	辖
恆	恒
爍	烁
孌	娈
僑	侨
闓	闿
緣	缘
驢	驴
諭	谕
惱	恼
鰾	鳔
鯷	鳀
燻	熏
狽	狈
獼	猕
響	响
鑾	銮
薈	荟
騍	骒
們	们
謗	谤
愛	爱
躚	跹
蒞	莅
頡	颉
鴣	鸪
帥	帅
閨	闺
險	险
設	设
輯	辑
應	应
緲	缈
枴	拐
墶	垯
簹	筜
綸	纶
儻	傥
鈽	钸
觀	观
諂	谄
葉	叶
饋	馈
積	积
攣	挛
齏	齑
灑	洒
釐	厘
鋒	锋
棖	枨
汙	污
蝟	猬
臺	台
瑩	莹
盪	荡
詭	诡
潯	浔
魷	鱿
鷸	鹬
塢	坞
牽	牵
禍	祸
頌	颂
爐	炉
鄒	邹
鐔	镡
欖	榄
悅	悦
撟	挢
夢	梦
鶥	鹛
嶇	岖
錦	锦
阨	厄
貯	贮
戰	战
徹	彻
銻	锑
紺	绀
眾	众
頊	顼
鱠	鲙
鏷	镤
姍	姗
題	题
彎	弯
鏑	镝
縶	絷
兒	儿
闕	阙
鑔	镲
棗	枣
譖	谮
臝	裸
鯡	鲱
穠	秾
廣	广
饢	馕
鷥	鸶
層	层
諫	谏
勸	劝
輿	舆
翹	翘
勻	匀
萵	莴
遼	辽
謁	谒
贅	赘
暈	晕
薊	蓟
鰏	鲾
瘓	痪
熒	荧
甕	瓮
讖	谶
螞	蚂
嬡	嫒
縣	县
瀧	泷
鎦	镏
嚨	咙
喪	丧
鵐	鹀
澮	浍
憲	宪
頷	颔
鮶	鲪
鶺	鹡
琿	珲
牴	抵
譁	哗
賄	贿
籤	签
噓	嘘
燒	烧
瓔	璎
綴	缀
淚	泪
餘	馀,余
摟	搂
幣	币
駢	骈
駐	驻
橫	横
渦	涡
業	业
捱	挨
懲	惩
敵	敌
擴	扩
寶	宝
鉻	铬
鷺	鹭
鑿	凿
檁	檩
謀	谋
贄	贽
暉	晖
箋	笺
萊	莱
餌	饵
綏	绥
劑	剂
錐	锥
訖	讫
亙	亘
掛	挂
愜	惬
薟	莶
蘞	蔹
羣	群
蘇	苏
鈦	钛
殫	殚
鄉	乡
趲	趱
騶	驺
鰺	鲹
儼	俨
閿	阌
濃	浓
賅	赅
懇	恳
曉	晓
篋	箧
饌	馔
銹	锈
韓	韩
詖	诐
癥	症
換	换
顢	颟
鳥	鸟
釧	钏
蒐	搜
靨	靥
瑪	玛
聲	声
榿	桤
鱺	鲡
腫	肿
樁	桩
讀	读
較	较
嬋	婵
鏃	镞
鈑	钣
圓	圆
閔	闵
渙	涣
鰥	鳏
鄧	邓
銦	铟
嘩	哗
謫	谪
覬	觊
搵	揾
餷	馇
窶	窭
縹	缥
猻	狲
詁	诂
毀	毁
慇	殷
晉	晋
蟈	蝈
擊	击
額	额
鉑	铂
鏐	镠
鑕	锧
闔	阖
論	论
鶴	鹤
賚	赉
穡	穑
齣	出
壢	坜
內	内
鋦	锔
癩	癞
譫	谵
艱	艰
惲	恽
藴	蕴
競	竞
幹	干
卻	卻,却
偽	伪
燼	烬
攆	撵
龍	龙
鸌	鹱
餎	饹
閑	闲
鐐	镣
園	园
鈔	钞
贖	赎
馮	冯
騤	骙
甦	苏
瀨	濑
貫	贯
辭	辞
測	测
檯	台
頸	颈
轂	毂
曇	昙
蕆	蒇
臉	脸
荊	荆
髏	髅
颸	飔
譚	谭
虜	虏
緡	缗
籠	笼
磣	碜
驤	骧
盧	卢
釩	钒
賫	赍
獪	狯
鉦	钲
黷	黩
發	发
謅	诌
誄	诔
昇	升
尋	寻
莊	庄
續	续
騏	骐
禎	祯
錕	锟
梘	枧
讚	赞
紡	纺
龢	和
鬥	斗
瘧	疟
邨	村
氫	氢
嗆	呛
榮	荣
漬	渍
縷	缕
碸	砜
霽	霁
鈿	钿
熾	炽
賀	贺
係	系
諄	谆
黌	黉
驏	骣
軌	轨
絡	络
遺	遗
癧	疬
煩	烦
僨	偾
滬	沪
擰	拧
聳	耸
蟲	虫
緶	缏
鱒	鳟
鉿	铪
燾	焘
䲁	鳚
誅	诛
欄	栏
搆	构
脈	脉
舊	旧
箏	筝
頎	颀
澗	涧
褘	袆
岡	冈
嬤	嬷
鐦	锎
刪	删
躭	耽
輬	辌
殯	殡
雜	杂
閻	阎
鎿	镎
瀾	澜
賁	贲
鵡	鹉
槃	盘
巋	岿
猶	犹
彌	弥
顎	颚
釓	钆
癒	愈
動	动
鍔	锷
聞	闻
鵠	鹄
擱	搁
兩	两
亂	乱
樅	枞
鉀	钾
紋	纹
後	后
鈕	钮
鎔	镕
沖	冲
覘	觇
攛	撺
誚	诮
簡	简
綠	绿
霧	雾
璦	瑷
銪	铕
強	强
頹	颓
獵	猎
窺	窥
嘽	啴
瞼	睑
傾	倾
蓆	席
臍	脐
鑑	鉴
闐	阗
鉕	钷
診	诊
櫚	榈
晝	昼
締	缔
廢	废
驥	骥
鯤	鲲
適	适
鋪	铺
濬	浚
譯	译
腳	脚
菴	庵
罷	罢
島	岛
塹	堑
駸	骎
嫺	娴
陽	阳
蜆	蚬
興	兴
喬	乔
銓	铨
陘	陉
記	记
諛	谀
謄	誊
崢	峥
頤	颐
鎩	铩
溫	温
優	优
氬	氩
枱	台
騸	骟
隻	只
閽	阍
俁	俣
叡	睿
櫃	柜
擇	择
籌	筹
魎	魉
釕	钌
達	达
詘	诎
藝	艺
摜	掼
絢	绚
硤	硖
靦	腼
軫	轸
豬	猪
嶼	屿
電	电
鑼	锣
鍾	钟
漁	渔
訃	讣
萇	苌
縋	缒
憊	惫
崍	崃
頏	颃
鮎	鲇
霑	沾
嚐	尝
閒	闲
儕	侪
蓯	苁
侖	仑
謙	谦
誘	诱
攝	摄
綢	绸
夥	伙,夥
鐧	锏
鞦	秋
銨	铵
踫	碰
冪	幂
責	责
殮	殓
誼	谊
尷	尴
羶	膻
甽	圳
咼	呙
潁	颍
軀	躯
棄	弃
塏	垲
闒	阘
陸	陆
譙	谯
虛	虚
齡	龄
廠	厂
鍩	锘
鋨	锇
賬	账
東	东
鱷	鳄
現	现
氂	牦
蘆	芦
羋	芈
騎	骑
鐒	铹
儔	俦
攜	携
銩	铥
錨	锚
覯	觏
暱	昵
瘲	疭
悵	怅
愴	怆
帶	带
鯫	鲰
嬸	婶
櫞	橼
璽	玺
爾	尔
轀	辒
綺	绮
齷	龌
穎	颖
囑	嘱
鑒	鉴
僕	仆
識	识
懟	怼
扞	捍
廡	庑
齠	龆
屢	屡
噦	哕
勩	勚
獨	独
濫	滥
賭	赌
浬	里
詮	诠
鴕	鸵
韻	韵
況	况
節	节
壪	塆
蠅	蝇
舉	举
簍	篓
綌	绤
餏	饻
逕	径
贗	赝
準	准
標	标
殘	残
徠	徕
癮	瘾
嚦	呖
玨	珏
撲	扑
酈	郦
確	确
緋	绯
賂	赂
曆	历
齋	斋
屍	尸
罌	罂
違	违
釔	钇
毘	毗
慟	恸
繡	绣
糢	模
顥	颢
鏨	錾
襯	衬
諮	咨
荳	豆
擲	掷
聵	聩
壺	壶
鑽	钻
協	协
倀	伥
鶉	鹑
鰈	鲽
蠐	蛴
貓	猫
欒	栾
鄖	郧
鐘	钟
箝	钳
稜	棱
巖	岩
鴞	鸮
撣	掸
輪	轮
厭	厌
睜	睁
禱	祷
頰	颊
徵	徵,征
癰	痈
証	证
釁	衅
竇	窦
鱈	鳕
齊	齐
蕎	荞
賓	宾
濕	湿
勗	勖
皸	皲
痙	痉
飛	飞
靚	靓
鯝	鲴
廟	庙
絞	绞
擣	捣
諧	谐
鉬	钼
颼	飕
駱	骆
顰	颦
鳳	凤
慶	庆
藹	蔼
詼	诙
滿	满
鍁	锨
鐃	铙
鎂	镁
紉	纫
茍	苟
讒	谗
伕	夫
難	难
醖	酝
嬝	袅
縟	缛
綞	缍
莢	荚
榦	干
洩	泄
貨	货
倫	伦
匭	匦
銬	铐
嘯	啸
單	单
餱	糇
鰳	鳓
噲	哙
張	张
麴	曲
憶	忆
蠻	蛮
欽	钦
剋	克
鷊	鹝
藎	荩
軔	轫
鉗	钳
顛	颠
矚	瞩
幟	帜
緞	缎
腡	脶
災	灾
噯	嗳
罵	骂
黴	霉
艷	艳
懶	懒
濁	浊
柺	拐
譽	誉
諼	谖
邁	迈
儀	仪
閃	闪
箇	个
順	顺
紈	纨
縊	缢
躂	跶
躕	蹰
輔	辅
鎗	枪
倖	幸
騅	骓
簞	箪
熱	热
販	贩
醫	医
鐮	镰
颱	台
瀉	泻
茲	兹
麵	面
鱟	鲎
蘺	蓠
氾	泛
闃	阒
囅	冁
靄	霭
鯇	鲩
顆	颗
綹	绺
詒	诒
轔	辚
鏗	铿
駛	驶
惡	恶
鋭	锐
鍬	锹
矯	矫
鷳	鹇
聶	聂
數	数
佔	占
鰉	鳇
綈	绨
纊	纩
蠑	蝾
贓	赃
摯	挚
傖	伧
鐙	镫
閘	闸
餛	馄
皚	皑
膠	胶
蔣	蒋
嶢	峣
趨	趋
躪	躏
爭	争
鎬	镐
報	报
紳	绅
縵	缦
悶	闷
褻	亵
殼	壳
漿	浆
鳴	鸣
釀	酿
飆	飙
鱉	鳖
態	态
諒	谅
蹕	跸
齟	龃
糞	粪
臠	脔
淨	净
鉭	钽
顱	颅
絳	绛
鹵	卤
蛺	蛱
潿	涠
賾	赜
鈀	钯
儂	侬
鬆	松
縈	萦
訐	讦
躓	踬
趕	赶
颮	飑
妝	妆
頜	颌
採	采
銫	铯
騰	腾
綵	彩
輈	辀
檻	槛
啞	哑
覽	览
貿	贸
輾	辗
縞	缟
牀	床
盃	杯
鑄	铸
壇	坛
筆	笔
拋	抛
窯	窑
懍	懔
詐	诈
豔	艳
韙	韪
癘	疠
駝	驼
硜	硁
藥	药
棧	栈
燭	烛
廳	厅
櫻	樱
錁	锞
銀	银
頇	顸
鼉	鼍
纈	缬
鎖	锁
娛	娱
喚	唤
墜	坠
鰟	鳑
從	从
蔥	葱
輩	辈
鄭	郑
鬱	郁
帳	帐
紵	纻
註	注
薺	荠
谿	溪
獁	犸
狀	状
鼴	鼹
廈	厦
緊	紧
慍	愠
蟎	螨
鷹	鹰
驛	驿
嗚	呜
籟	籁
臢	臜
淪	沦
瑯	琅
繳	缴
糴	籴
職	职
書	书
藺	蔺
與	与
濾	滤
唄	呗
鼈	鳖
誑	诳
謐	谧
贔	赑
熗	炝
嚙	啮
團	团
瘮	瘆
餜	馃
鸞	鸾
撥	拨
攤	摊
噝	咝
傭	佣
嘮	唠
嬰	婴
砲	炮
粵	粤
鴴	鸻
戶	户
渾	浑
鋁	铝
鍀	锝
韃	鞑
彈	弹
諑	诼
歐	欧
賕	赇
釗	钊
雙	双
鯛	鲷
饜	餍
篤	笃
蟣	虮
琺	珐
槧	椠
試	试
煬	炀
餼	饩
灩	滟
鶿	鹚
懷	怀
懨	恹
蝸	蜗
摺	摺,折
製	制
乾	乾,干
鈁	钫
勁	劲
區	区
縉	缙
羈	羁
攏	拢
樑	梁
紙	纸
輓	挽
犖	荦
堝	埚
鴟	鸱
搥	捶
誦	诵
錫	锡
貪	贪
醬	酱
甯	宁
嚮	向
稱	称
雲	云
鰵	鳘
嶴	岙
愷	恺
罈	坛
僂	偻
彷	彷,仿
糶	粜
鰣	鲥
銑	铣
兗	兖
魛	鱽
瓚	瓒
點	点
諺	谚
諦	谛
鰍	鳅
質	质
燬	毁
飲	饮
練	练
擺	摆
滾	滚
鈄	钭
紆	纡
須	须
輒	辄
讕	谰
瀘	泸
錚	铮
篛	箬
餞	饯
櫧	槠
璫	珰
瞭	瞭,了
吳	吴
綱	纲
墳	坟
費	费
繞	绕
調	调
嚴	严
靂	雳
剄	刭
絆	绊
蓋	盖
腎	肾
豐	丰
詔	诏
釙	钋
灘	滩
饞	馋
艤	舣
癬	癣
鋯	锆
緱	缑
齲	龋
寵	宠
繹	绎
賻	赙
綆	绠
餉	饷
鮊	鲌
檔	档
嘗	尝
傘	伞
鰛	鳁
鎚	锤
纜	缆
稟	禀
櫱	蘖
螢	萤
鐫	镌
紱	绂
脹	胀
溼	湿
偺	咱
灃	沣
獅	狮
饉	馑
鯊	鲨
誣	诬
術	术
闖	闯
煙	烟
驟	骤
擠	挤
撓	挠
湧	涌
磽	硗
統	统
糰	团
顳	颞
藶	苈
繾	缱
軼	轶
詿	诖
醃	腌
銅	铜
錄	录
玀	猡
贐	赆
覓	觅
誕	诞
謔	谑
備	备
儘	尽
蘢	茏
喫	吃
訪	访
櫂	棹
鴰	鸹
馳	驰
縲	缧
搶	抢
凃	涂
療	疗
鋅	锌
獄	狱
屆	届
饈	馐
驊	骅
賑	赈
槓	杠
寢	寝
鉚	铆
廝	厮
齜	龇
類	类
懣	懑
楨	桢
燦	灿
糱	糵
鵰	雕
嫵	妩
魴	鲂
摶	抟
腸	肠
份	份,分
毿	毵
門	门
鎄	锿
鼇	鳌
銖	铢
躒	跞
訕	讪
這	这
紛	纷
銚	铫
縝	缜
龜	龟
脣	唇
暢	畅
說	说
匯	汇
鰱	鲢
綰	绾
餳	饧
囂	嚣
鉅	巨
叄	叁
秈	籼
竊	窃
楓	枫
軒	轩
評	评
遙	遥
釘	钉
絛	绦
歎	叹
壞	坏
鈾	铀
慣	惯
迺	乃
賦	赋
槨	椁
畫	画,划
櫪	枥
癭	瘿
巰	巯
鯴	鲺
聹	聍
懸	悬
濼	泺
歿	殁
瘀	淤
劃	划
稈	秆
養	养
踐	践
樂	乐
蠔	蚝
圖	图
厙	厍
攢	攒
貧	贫
輦	辇
瀆	渎
閭	闾
傯	偬
錮	锢
紲	绁
場	场
謾	谩
韁	缰
鋃	锒
釅	酽
灄	滠
彆	别
鯉	鲤
饊	馓
藍	蓝
櫓	橹
牘	牍
緝	缉
屜	屉
壟	垄
塤	埙
蕢	蒉
臥	卧
襪	袜
獮	狝
繰	缲
鵲	鹊
顴	颧
擷	撷
揹	背
隕	陨
軻	轲
譾	谫
嚀	咛
鈃	钘
閂	闩
臟	脏
還	还
將	将
羆	罴
蘋	苹
屬	属
樓	楼
飯	饭
猙	狰
銘	铭
縛	缚
鴝	鸲
辦	办
誨	诲
親	亲
鎮	镇
網	网
餵	喂
貼	贴
囀	啭
敍	叙
懌	怿
潑	泼
淒	凄
絝	绔
曠	旷
櫨	栌
珮	佩
鷲	鹫
飴	饴
葷	荤
蟶	蛏
懺	忏
購	购
桿	杆
億	亿
鶇	鸫
嬈	娆
堊	垩
躑	踯
讓	让
嘖	啧
錘	锤
紜	纭
並	并
謨	谟
鈮	铌
斷	断
貽	贻
覿	觌
囁	嗫
參	参
呂	吕
僅	仅
緇	缁
繆	缪
納	纳
塊	块
臏	膑
軑	轪
務	务
鍘	铡
糝	糁
鵜	鹈
駟	驷
畬	畲
剮	剐
罰	罚
篳	筚
籲	吁
賽	赛
獫	猃
鞀	鼗
钂	镋
瀅	滢
紇	纥
墊	垫
損	损
薌	芗
澐	沄
沒	没
鎘	镉
傚	效
綜	综
憤	愤
躦	躜
閬	阆
縱	纵
馴	驯
輻	辐
涼	凉
檾	苘
噁	恶
鍃	锪
燄	焰
樣	样
賒	赊
觔	筋
雖	虽
鏘	锵
豎	竖
鱝	鲼
恥	耻
詩	诗
鑭	镧
糲	粝
塵	尘
蕷	蓣
菸	烟
軾	轼
跼	局
諾	诺
羅	罗
劇	剧
鄆	郓
閉	闭
訌	讧
憑	凭
蒓	莼
鮮	鲜
梲	棁
覡	觋
薩	萨
勝	胜
鴆	鸩
鮭	鲑
紮	扎
醱	酦
瀰	弥
閲	阅
駁	驳
權	权
鰷	鲦
鋇	钡
穢	秽
嫗	妪
緙	缂
鱘	鲟
鏝	镘
潤	润
賣	卖
蹤	踪
苧	苎
腦	脑
飫	饫
鵮	鹐
凱	凯
獲	获
噴	喷
諷	讽
惻	恻
鰃	鳂
宂	冗
誌	志
崙	仑
銜	衔
氣	气
輥	辊
戧	戗
攩	挡
頫	俯
縯	演
鐳	镭
厲	厉
隴	陇
貸	贷
蘿	萝
饁	馌
飀	飗
籃	篮
廄	厩
則	则
鐠	镨
蝕	蚀
顏	颜
驗	验
癟	瘪
闞	阚
蹺	跷
軤	轷
蕩	荡
顫	颤
繯	缳
坵	丘
觶	觯
浹	浃
賸	剩
濺	溅
綃	绡
騂	骍
鎇	镅
倆	俩
璉	琏
見	见
認	认
鸚	鹦
躥	蹿
莧	苋
颳	刮
鄰	邻
蠶	蚕
搾	榨
驂	骖
構	构
諍	诤
汎	泛
鯗	鲞
繚	缭
鋝	锊
鑞	镴
裡	里
襠	裆
橢	椭
轤	轳
籮	箩
僱	雇
痳	麻
夾	夹
繫	系
頁	页
錇	锫
隊	队
憐	怜
硯	砚
鶘	鹕
脛	胫
檢	检
澤	泽
礫	砾
騭	骘
週	周
銲	焊
嘵	哓
氹	凼
擋	挡
撾	挝
絃	弦
繅	缫
鍇	锴
義	义
闈	闱
處	处
諸	诸
籙	箓
緘	缄
廚	厨
剝	剥
鏜	镗
諢	诨
濤	涛
婭	娅
寬	宽
歷	历
棶	梾
軺	轺
擾	扰
鮁	鲅
邇	迩
錆	锖
燙	烫
斕	斓
犛	牦
級	级
礄	硚
攪	搅
馭	驭
鈰	铈
嚳	喾
儲	储
芻	刍
膽	胆
撿	捡
鯁	鲠
穀	谷
黃	黄
鍆	钔
韉	鞯
沍	冱
請	请
颶	飓
槍	枪
澦	滪
轎	轿
鰹	鲣
嶸	嵘
幘	帻
勛	勋
針	针
遜	逊
睞	睐
詠	咏
淥	渌
贊	赞
蕪	芜
駭	骇
顬	颥
峯	峰
吒	咤
鄔	邬
紅	红
玆	兹
疊	叠
鵃	鸼
芐	苄
憒	愦
蒔	莳
頗	颇
纘	缵
爛	烂
鶚	鹗
瞞	瞒
誠	诚
壽	寿
騫	骞
匱	匮
繃	绷
驍	骁
橋	桥
嗊	唝
蕕	莸
擔	担
塗	涂
鯖	鲭
彙	汇
剛	刚
鷚	鹨
韞	韫
歡	欢
蹣	蹒
鍺	锗
賤	贱
燐	磷
曨	昽
穫	获
藪	薮
鹼	碱,硷
鋰	锂
陳	陈
滸	浒
淺	浅
頂	顶
約	约
隉	陧
琊	玡
褌	裈
攔	拦
騖	骛
鎛	镈
種	种
瘞	瘗
誡	诫
謠	谣
鮫	鲛
碭	砀
餬	糊
綯	绹
縮	缩
銱	铞
進	进
璵	玙
覷	觑
訶	诃
漸	渐
悽	凄
鐋	铴
組	组
牆	墙
囉	啰
靈	灵
鑊	镬
陞	升
諡	谥
艦	舰
蝨	虱
寫	写
飭	饬
鷯	鹩
勱	劢
鍰	锾
遲	迟
軹	轵
決	决
慼	戚
騁	骋
囪	囱
嶄	崭
瘉	愈
蠍	蝎
贏	赢
專	专
薔	蔷
錛	锛
瀝	沥
醜	丑
嶠	峤
漣	涟
嗇	啬
頭	头
馬	马
鴯	鸸
鎰	镒
鐵	铁
誶	谇
貺	贶
婁	娄
鯀	鲧
鱅	鳙
緄	绲
煇	辉
癉	瘅
瓊	琼
倣	仿
滎	荥
饗	飨
髖	髋
鍛	锻
灝	灏
凜	凛
啟	启
雞	鸡
詡	诩
孫	孙
鵯	鹎
鏰	镚
瑒	玚
諶	谌
賺	赚
聽	听
懼	惧
嶁	嵝
簀	箦
緗	缃
嚇	吓
薑	姜
戔	戋
麗	丽
領	领
鬚	须
嘜	唛
漢	汉
蔦	茑
膩	腻
媯	妫
閱	阅
傳	传
鎵	镓
鈴	铃
洶	汹
撻	挞
愾	忾
驄	骢
燉	炖
鍊	炼
蹌	跄
諏	诹
駙	驸
願	愿
魚	鱼
陜	陕
鋟	锓
跡	迹
轢	轹
鈐	钤
幬	帱
奮	奋
鑰	钥
鏵	铧
剴	剀
擻	擞
慾	欲
頃	顷
儉	俭
鎊	镑
赬	赪
撐	撑
礙	碍
醞	酝
負	负
蠣	蛎
誤	误
薦	荐
脩	修
簫	箫
禮	礼
環	环
殺	杀
鴛	鸳
膾	脍
硃	朱
竄	窜
癇	痫
闆	板
煉	炼
轍	辙
滌	涤
幗	帼
緖	绪
壘	垒
盜	盗
賠	赔
諤	谔
虧	亏
廬	庐
鍵	键
淶	涞
摻	掺
懾	慑
紀	纪
瞇	眯
澀	涩
儈	侩
躍	跃
項	项
財	财
渢	沨
誥	诰
愨	悫
鳧	凫
鄲	郸
侷	局
褸	褛
樺	桦
絀	绌
竅	窍
矇	蒙
僉	佥
對	对
軍	军
鱖	鳜
壙	圹
驚	惊
靜	静
鏟	铲
遞	递
賡	赓
櫥	橱
蹧	糟
葦	苇
緦	缌
齬	龉
異	异
癲	癫
勵	励
瀕	濒
聾	聋
鰁	鳈
餃	饺
稅	税
紗	纱
圇	囵
驀	蓦
倉	仓
贋	赝
劊	刽
欏	椤
錟	锬
訥	讷
殤	殇
朧	胧
縭	缡
徬	彷
墮	堕
嚲	亸
厴	厣
貶	贬
饃	馍
廂	厢
驅	驱
範	范
偉	伟
燈	灯
譏	讥
摑	掴
顙	颡
駘	骀
陝	陕
韜	韬
臨	临
繭	茧
翬	翚
魯	鲁
鑱	镵
煒	炜
創	创
觸	触
櫺	棂
紂	纣
謖	谡
鈈	钚
躋	跻
氌	氇
謎	谜
鷙	鸷
際	际
餚	肴
檣	樯
庫	库
維	维
颯	飒
鬮	阄
嘰	叽
銳	锐
買	买
樸	朴
疋	匹
挾	挟
幀	帧
鵂	鸺
鉈	铊
軋	轧
裏	里
譎	谲
蕒	荬
雛	雏
郟	郏
鱤	鳡
颺	扬
蝦	虾
慪	怄
籬	篱
磯	矶
閼	阏
陰	阴
勳	勋
釵	钗
側	侧
蛻	蜕
櫫	橥
騃	呆
餅	饼
學	学
冊	册
贍	赡
讎	雠
嬙	嫱
瀟	潇
訣	诀
搧	扇
縫	缝
堯	尧
宮	宫
皰	疱
喲	哟
傴	伛
侶	侣
謹	谨
檸	柠
覺	觉
蒼	苍
驃	骠
鷂	鹞
饅	馒
飄	飘
韆	千
終	终
鱗	鳞
畝	亩
鏞	镛
轡	辔
詣	诣
幫	帮
顯	显
痲	麻
烴	烃
櫸	榉
擼	撸
鮃	鲆
餄	饸
疇	畴
嘆	叹
劉	刘
錈	锩
貍	狸
規	规
討	讨
嶗	崂
鈞	钧
躡	蹑
磚	砖
細	细
妳	你
騮	骝
隱	隐
鎳	镍
鐲	镯
債	债
鄴	邺
誹	诽
螻	蝼
膿	脓
廁	厕
鱂	鳉
闇	暗
癆	痨
遊	游
詎	讵
葒	荭
鷗	鸥
繖	伞
魘	魇
塚	冢
綻	绽
營	营
鉞	钺
鈺	钰
襤	褴
捨	舍
鵬	鹏
鑲	镶
郵	邮
歸	归
蟻	蚁
蓽	荜
堅	坚
鈉	钠
邊	边
釃	酾
崗	岗
纖	纤
騙	骗
鐝	镢
償	偿
両	两
澠	渑
貢	贡
戩	戬
鰭	鳍
綬	绶
窮	穷
錳	锰
樹	树
於	于,於
孃	娘
鉉	铉
鏈	链
襏	袯
壚	垆
關	关
勞	劳
俠	侠
賢	贤
槤	梿
嵐	岚
彫	雕
鱭	鲚
緬	缅
髮	发
癱	瘫
繒	缯
偵	侦
燴	烩
隨	随
